11111111111111111111111111111111111111111111111111111111111
10000100000000000000000000000000000000000000000011111111111
10000001000000000000000000000000000000000000000011111111111
1000010000000000000111000000C000000000000000000011111111111
1P000001000C00000001C0000000000000000C000000000E11111111111
1000010000000000000111000000C000000000000000000011111111111
10000001000000000000000000000000000000000000000011111111111
10000100000000000000000000000000000000000000000011111111111
11111111111111111111111111111111111111111111111111111111111
11111111111111111111111111111111111111111111111111111111111
11111111111111111111111111111111111111111111111111111111111
11111111111111111111111111111111111111111111111111111111111
11111111111111111111111111111111111111111111111111111111111
11111111111111111111111111111111111111111111111111111111111
11111111111111111111111111111111111111111111111111111111111