1111111111111111111111111111111111111111111111111111111111111111111111111111111111111111111111111111111
1111111111111111111111111111111111111111111111111111111111111111111111111111111111111111111111111111111
1P00000000000000000000000000000000000000000000000011111110000000000000000000010101010101000011111111111
1000001111111111111111111111111111111110000000000011111110000100000000000000001010101010000011111111111
1000000000000000000000000000000000000C10000000000011111110000001000000000000000101010100000011111111111
1000001111111111111111111111111111111010000000000011111110000000000000000000000010101000000011111111111
1000001111111111111111111111111111111010000000000011111110000100000000000000000001010000000011111111111
1011100000000000000000000000000000000C1E000000000011111111C00000000000000000000000100000000011111111111
1000111111111111111111111111111111111111111111111011111111001C00010100000000000000100000000011111111111
100011111111111111111111111111111111111111111111101111111C000100110000000000000000000000000111111111111
10001111111111111111111111111111111111111111111110111111110000100000000000000C0000000000001111111111111
1000111111111111111111111111111111111111111111111011111111CC1100000000000000000000000001111111111111111
1000000000000000000000000000000C0000000000000000101000100011000100000000000000000000000C000000011111111
100000000000000000000000000000C1C0000000000000001000100010000000000000000000000000000001111111011111111
1111111111111110000000000000001C10000000000000001111111110000000000000000000000000000000001111011111111
100000000000000000000000000001C000000000000000000000000000000000000000000000000000000000000111011111111
1110111111111111111111111111111111111111111111111111111111111111111111111111111111111111111111011111111
1C00000000000000000000000000000000000000000000000000000000000000000000000000000000000000000000011111111
1111111111111111111111111111111111111111111111111111111111111111111111111111111111111111111111111111111
1111111111111111111111111111111111111111111111111111111111111111111111111111111111111111111111111111111
1111111111111111111111111111111111111111111111111111111111111111111111111111111111111111111111111111111
1111111111111111111111111111111111111111111111111111111111111111111111111111111111111111111111111111111
1111111111111111111111111111111111111111111111111111111111111111111111111111111111111111111111111111111
1111111111111111111111111111111111111111111111111111111111111111111111111111111111111111111111111111111