11111111111111111111111111111111111111111111111111111111111
11111111111111111111111111111111111111111111111111111111111
111P1111111111111111111111111111111111111111111111111111111
11101111111111111111111111111111111111111111111111111111111
11101111111111111111111111111111111111111111111111111111111
11101111111111111111111111111111111111111111111111111111111
11101111111111111111111111111111111111111111111111111111111
11101111111111111111111111111111111111111111111111111111111
11101111111111111111111111111111111111111111111111111111111
11101111111111111111111111111111111111111111111111111111111
1110C000000000000000000000000000011111111111111111111111111
1110111111111111111111111111111111111110C000C01111111111111
111010C000000000C000000000000000000000101111101111111111111
11101011111111111000000000000000000000101CCC101111111111111
11101011111111111000000000000000000CCC1010C0101111111111111
11101011111111111000000000000000000CEC101000100011111111111
11101011111111111111111111111111111111101000111011111111111
111010C0000000000000000000000000000000C01000C01011111111111
1110111111111111111111111111111111111111111110C011111111111
1110C000000000000000000000000000000000000000001111111111111
11111111111111111111111111111111111111111111111111111111111
11111111111111111111111111111111111111111111111111111111111
11111111111111111111111111111111111111111111111111111111111
11111111111111111111111111111111111111111111111111111111111