11111111111111111111111111111111111111111111111111111111111
11111111111111111111111111111111111111111111111111111111111
11111111111111111111111111111111111111111111111111111111111
11111111111111111111111111111111111111111111111111111111111
11111111111111111111111111111111111111111111111111111111111
11111111111111111111111111111111111111111111111111111111111
100110001C0100000000000000000000000000000000000000000000001
10P00010010000000000000000000000001111111111111010000000001
10010100000000000000000000000000000000000000C00010000000001
1111111111111111111111111111111111111111111111111111111CCC1
111111111111111111111111111111111111111111111111111111CCCC1
111111111111111111111111C1111111111111111111111111111000011
11111111111111111111111101111111110001111111111111110000111
11111111111111111111110000011111100000111111111111100001111
1E000000000000000000000000000000001C10000001C10000000000001
11111111111111111111110000011111111111111100000111111111111
11111111111111111111111000111111111111111110001111111111111
11111111111111111111111101111111111111111111111111111111111
11111111111111111111111111111111111111111111111111111111111
11111111111111111111111111111111111111111111111111111111111
11111111111111111111111111111111111111111111111111111111111
11111111111111111111111111111111111111111111111111111111111
11111111111111111111111111111111111111111111111111111111111
11111111111111111111111111111111111111111111111111111111111