1111111111111111111111111111111111111111111111111111111111111111111111111111111111111111111111111111111
1110000000000000000000000000000000000000000000000000000000000000000000000000000000000000000011111111111
1110111111111111111111111111111111111111111111111111111111111111111111111111111111111111111011111111111
1110111111111111111111111111111111111111111111111111111111111111111111111111111111111111111011111111111
1110111111111111111111111111111111111111111111111111111111111111111111111111111111111111111011111111111
1110111111111111111111111111111111111111111111111111111111111111111111111111111111111111111011111111111
1110111111111111111111111111111111111111111111111111111111111111111111111111111111111111111011111111111
111C111111111111111111111111111111111111111111111111111111111111111111111111111111111111111011111111111
1E10P11111111111100000000000000000000000000000000000000000000000000000000000000000000000000011111111111
101C1111111111111C1111111111111111111111111111111111111111111111111111111111111111111111111111111111111
1010111111111111111111111111111111111111111111111111111111111111111111111111111111111111111C11111111111
1010111111111111111111111111111111111111111111111111111111111111111111111111111111111111111011111111111
1010111111111111111111111111111111111111111111111111111111111111111111111111111111111111111011111111111
1010111111111111111111111111111111111111111111111111111111111111111111111111111111111111111011111111111
1010111111111111111111111111111111111111111111111111111111111111111111111111111111111111111011111111111
1010111111111111111111111111111111111111111111111111111111111111111111111111111111111111111011111111111
1010000000000000000000000000000000000000000000000000000000000000000000000000000000000000000011111111111
1011111111111111111111111111111111111111111111111111111111111111111111111111111111111111111011111111111
1000000000000000000000000000000000000000000000000000000000000000000000000000000000000000000011111111111
1111111111111111111111111111111111111111111111111111111111111111111111111111111111111111111111111111111
1111111111111111111111111111111111111111111111111111111111111111111111111111111111111111111111111111111
1111111111111111111111111111111111111111111111111111111111111111111111111111111111111111111111111111111
1111111111111111111111111111111111111111111111111111111111111111111111111111111111111111111111111111111